NO ./pixel_art/wall1.png
SO ./pixel_art/wall2.png
WE ./pixel_art/wall3.png
EA ./pixel_art/wall4.png
F 36,36,36
C ./pixel_art/orig.png


111111111111111111111111111
100000000011000001000000101
1011000100010000000001001001
1001000100000000000000000011
111111111011000001110000111111111
100001000011000001110011110111111
11110001111111001110000001001
11110111100011001101010000001
11000000110101001100000000001
10000100000000000100000010001
10000100000000000101010010001
11000001110101011111011110N0111
11100111 1110101 100011000001
11111111 1111111 111111111111
