NO ./pixel_art/wall1.png
SO ./pixel_art/wall2.png
WE ./pixel_art/wall3.png
EA ./pixel_art/wall4.png
F 36,36,36
C 30,42,86


1111111111111111111111111
1000000000110000010000001
1011000000010000000000001
1001000000000000000000001
111111111011000001110000000000001
100001000011000001110111111111111
111100011111110011100000010001
11110111111111011101010010001
11000000110101011100000000001
10000100000000001100000010001
10000100000000001101010010001
11000001110101011111011110N0111
11110111 1110101 101111010001
11111111 1111111 111111111111
