NO ./pixel_art/wall1.png
SO ./pixel_art/wall2.png
WE ./pixel_art/wall3.png
EA ./pixel_art/wall4.png
F 220,100,0
C 225,30,0


111111111111111
100111000000001
100000000111001
100000000000001
100000000000001
1000000N0000001
100000000000001
100000000000001
100000000000001
111111111111111
