NO ./pixel_art/wall1.png
SO ./pixel_art/wall2.png
WE ./pixel_art/wall3.png
EA ./pixel_art/wall4.png
F 220,100,0
C 225,30,0


1111111111111
10A000000001
10000X0000001
1111111111111
